"filename", "language", "Vue", "TypeScript", "Less", "CSS", "comment", "blank", "total"
"e:\Infor\mylog2\src\App.vue", "Vue", 9, 0, 0, 0, 3, 3, 15
"e:\Infor\mylog2\src\api\log.ts", "TypeScript", 0, 38, 0, 0, 17, 4, 59
"e:\Infor\mylog2\src\api\user.ts", "TypeScript", 0, 30, 0, 0, 21, 9, 60
"e:\Infor\mylog2\src\assets\css\base.less", "Less", 0, 0, 87, 0, 19, 16, 122
"e:\Infor\mylog2\src\assets\css\markdown\main.less", "Less", 0, 0, 63, 0, 5, 16, 84
"e:\Infor\mylog2\src\assets\css\themes\dark.css", "CSS", 0, 0, 0, 17, 91, 10, 118
"e:\Infor\mylog2\src\assets\css\themes\light.css", "CSS", 0, 0, 0, 101, 14, 23, 138
"e:\Infor\mylog2\src\components\Log\Log.vue", "Vue", 96, 0, 0, 0, 14, 22, 132
"e:\Infor\mylog2\src\components\Log\LogLoading.vue", "Vue", 14, 0, 0, 0, 0, 3, 17
"e:\Infor\mylog2\src\components\Log\LogMylog.vue", "Vue", 97, 0, 0, 0, 7, 21, 125
"e:\Infor\mylog2\src\components\Login\LoginComp.vue", "Vue", 129, 0, 0, 0, 0, 22, 151
"e:\Infor\mylog2\src\components\Login\SigninComp.vue", "Vue", 151, 0, 0, 0, 12, 31, 194
"e:\Infor\mylog2\src\components\Login\StructLogin.vue", "Vue", 95, 0, 0, 0, 0, 21, 116
"e:\Infor\mylog2\src\components\MainPage\Home\HomePage.vue", "Vue", 19, 0, 0, 0, 3, 7, 29
"e:\Infor\mylog2\src\components\MainPage\Home\HomeTopLog.vue", "Vue", 62, 0, 0, 0, 3, 9, 74
"e:\Infor\mylog2\src\components\MainPage\Logger\LoggerPage.vue", "Vue", 6, 0, 0, 0, 0, 3, 9
"e:\Infor\mylog2\src\components\MainPage\Map\MapPage.vue", "Vue", 54, 0, 0, 0, 0, 8, 62
"e:\Infor\mylog2\src\components\MainPage\Mylog\MylogPage.vue", "Vue", 82, 0, 0, 0, 2, 15, 99
"e:\Infor\mylog2\src\components\MainPage\Mylog\Release\EditImgs.vue", "Vue", 176, 0, 0, 0, 27, 24, 227
"e:\Infor\mylog2\src\components\MainPage\Mylog\Release\EditLocation.vue", "Vue", 33, 0, 0, 0, 0, 8, 41
"e:\Infor\mylog2\src\components\MainPage\Mylog\Release\EditTags.vue", "Vue", 45, 0, 0, 0, 0, 8, 53
"e:\Infor\mylog2\src\components\MainPage\Mylog\Release\EditTime.vue", "Vue", 24, 0, 0, 0, 4, 5, 33
"e:\Infor\mylog2\src\components\MainPage\Mylog\Release\LogRelease.vue", "Vue", 129, 0, 0, 0, 0, 21, 150
"e:\Infor\mylog2\src\components\MainPage\Mylog\Release\types.d.ts", "TypeScript", 0, 9, 0, 0, 3, 3, 15
"e:\Infor\mylog2\src\components\Main\FooterComp.vue", "Vue", 136, 0, 0, 0, 0, 20, 156
"e:\Infor\mylog2\src\components\Main\HeaderComp.vue", "Vue", 107, 0, 0, 0, 0, 19, 126
"e:\Infor\mylog2\src\components\Main\Lans\OneSentence.vue", "Vue", 29, 0, 0, 0, 0, 5, 34
"e:\Infor\mylog2\src\components\Main\Lans\UserLan.vue", "Vue", 54, 0, 0, 0, 1, 4, 59
"e:\Infor\mylog2\src\components\Main\MainComp.vue", "Vue", 60, 0, 0, 0, 3, 13, 76
"e:\Infor\mylog2\src\components\Utils\TeleportBody.vue", "Vue", 31, 0, 0, 0, 0, 5, 36
"e:\Infor\mylog2\src\components\Utils\ThemeSwitch.vue", "Vue", 9, 0, 0, 0, 1, 2, 12
"e:\Infor\mylog2\src\components\Utils\ViewerImgs.vue", "Vue", 104, 0, 0, 0, 8, 18, 130
"e:\Infor\mylog2\src\components\Utils\ViewerVideos.vue", "Vue", 64, 0, 0, 0, 9, 14, 87
"e:\Infor\mylog2\src\main.ts", "TypeScript", 0, 38, 0, 0, 4, 8, 50
"e:\Infor\mylog2\src\router\index.ts", "TypeScript", 0, 57, 0, 0, 1, 4, 62
"e:\Infor\mylog2\src\stores\constant.ts", "TypeScript", 0, 17, 0, 0, 4, 3, 24
"e:\Infor\mylog2\src\stores\global.ts", "TypeScript", 0, 45, 0, 0, 30, 16, 91
"e:\Infor\mylog2\src\stores\log.ts", "TypeScript", 0, 66, 0, 0, 20, 11, 97
"e:\Infor\mylog2\src\types.d.ts", "TypeScript", 0, 53, 0, 0, 7, 3, 63
"e:\Infor\mylog2\src\utils\cos.ts", "TypeScript", 0, 1, 0, 0, 0, 1, 2
"e:\Infor\mylog2\src\utils\img.ts", "TypeScript", 0, 82, 0, 0, 36, 11, 129
"e:\Infor\mylog2\src\utils\index.ts", "TypeScript", 0, 39, 0, 0, 40, 7, 86
"e:\Infor\mylog2\src\utils\map.ts", "TypeScript", 0, 60, 0, 0, 45, 9, 114
"e:\Infor\mylog2\src\utils\request.ts", "TypeScript", 0, 36, 0, 0, 19, 7, 62
"e:\Infor\mylog2\src\views\LoginView.vue", "Vue", 22, 0, 0, 0, 0, 6, 28
"e:\Infor\mylog2\src\views\MainView.vue", "Vue", 16, 0, 0, 0, 3, 5, 24
"e:\Infor\mylog2\src\views\NotFound.vue", "Vue", 9, 0, 0, 0, 0, 2, 11
"Total", "-", 1862, 571, 150, 118, 476, 505, 3682